111111111111111111111111
100000000000000000000001
100000000000000000000001
1000P0000000000000000001
100000010000000000000001
1000000100000C0000000001
100000010000000000E00001
10000001111110C010000001
100000000000000000000001
100000000B00000000000001
100000C00000001000000001
111111111111111111111111
