111111111111111111111111
100000000000000000000001
100000000100000000000001
1000P0001E100000C0000001
100000010000000000000001
1000000100B0000000000001
100000010000000000000001
100000011111100010000001
100000000000000C00000001
100000000B00000000000001
100000000000C01000000001
111111111111111111111111
